11111111111111111111111
100000000000000000E0PC1
11111111111111111111111