1111111111111
10010000000C1
1000011001001
100C011001001
100011E000001
1C00110000011
1C0001P011111
1111111111111