111111111111111
1E0000000010001
101001010010101
101101001010101
1P0010000010111
111110101001011
100000000E000C1
111111111111111
