111111111111111
100000000010001
101001010010101
101101001010101
1P0000000001011
111110101001011
100000000E000C1
111111111111111